27 25 25 25 25 25 25 25 25 26 25 27 25 25 25 25 25 25 25 25 25 25 25 25 25 25 25 25 25 25 26 25 27 25 25 25 25 25 25 25 25 25 25 27 25 25 25 25 25 26
25 25 26 25 25 25 25 25 25 25 25 25 25 25 25 25 25 25 25 25 25 25 25 25 25 25 25 25 25 25 25 25 25 25 25 25 25 26 25 25 25 25 25 26 25 25 27 25 25 25
27 25 25 25 27 25 25 25 25 25 25 25 25 25 25 25 27 25 25 25 25 25 25 25 25 26 27 25 25 25 25 25 25 25 27 25 25 25 25 25 27 25 25 25 25 25 25 25 25 25
25 25 25 25 25 25 25 25 26 25 25 25 25 25 25 25 25 25 25 25 25 25 25 25 25 25 25 25 25 25 25 25 25 25 25 25 25 25 25 25 25 25 25 25 26 25 25 25 25 25
25 25 25 25 25 25 25 25 25 25 25 25 25 25 25 25 25 25 25 25 25 27 26 25 25 25 25 25 25 25 25 25 25 26 25 25 25 25 25 25 26 25 25 25 25 25 25 26 25 25
25 27 26 25 25 25 25 25 25 25 25 25 25 25 25 25 25 25 25 25 25 25 25 25 25 25 25 25 25 25 25 25 25 25 25 25 25 25 25 25 25 25 25 25 25 25 25 25 25 25
25 25 25 25 25 25 36 35 35 35 35 35 35 35 35 35 35 35 35 37 25 25 36 35 35 35 35 35 35 35 35 35 35 35 35 35 35 37 36 35 35 35 37 26 25 25 25 25 25 25
25 25 25 25 25 25 32 10 10 10 43 10 10 10 43 44 10 40 11 31 25 25 32 21 19 19 19 19 19 19 19 19 19 19 19 22 10 33 34 10 10 43 33 37 27 25 25 25 26 25
25 25 25 25 25 25 32 10 44 10 11 10 10 10 10 10 10 10 10 31 26 25 32 18 12 12 12 12 12 12 12 12 12 12 12 17 11 10 44 11 10 10 10 31 25 25 25 25 25 25
25 26 25 25 25 25 32 10 10 21 19 22 43 10 11 10 10 10 10 33 35 35 34 18 12 13 20 20 20 20 20 20 20 14 12 17 44 11 43 10 10 10 10 31 25 26 25 25 27 25
25 25 25 25 25 25 32 43 10 18 12 17 10 10 40 10 40 10 10 21 19 19 19 15 12 17 43 10 10 43 10 10 10 18 12 17 10 11 44 10 44 10 11 31 25 25 25 25 25 25
25 27 25 25 25 25 32 10 10 18 12 17 10 10 10 10 40 11 10 18 12 12 12 12 12 17 10 11 10 44 10 10 10 18 12 17 43 10 43 10 10 10 10 31 25 25 25 25 25 25
25 25 25 25 25 25 32 43 11 18 12 16 19 19 19 19 19 19 19 15 12 13 20 20 20 23 10 44 40 10 10 43 10 18 12 17 11 11 10 10 10 44 10 31 25 25 25 25 25 25
25 25 25 25 25 25 32 10 10 18 12 12 12 12 12 12 12 12 12 12 12 17 10 10 10 10 10 10 10 10 44 10 10 18 12 17 21 19 22 43 11 43 10 31 25 25 25 25 25 25
25 25 27 26 25 25 32 10 10 18 12 13 20 20 20 20 20 20 20 20 20 23 10 10 10 10 44 10 10 10 10 11 11 18 12 17 18 12 17 10 10 10 10 31 25 25 25 25 25 27
25 26 25 25 25 25 32 10 10 18 12 17 10 10 10 10 11 40 10 10 10 10 10 43 10 10 10 11 44 10 10 43 10 18 12 16 15 12 17 10 10 44 10 31 25 25 25 25 25 25
25 25 25 25 25 25 32 11 10 18 12 17 10 10 43 10 10 10 43 10 40 43 10 10 10 10 10 10 10 44 10 10 10 18 12 12 12 12 17 11 10 10 11 31 25 25 25 25 25 25
25 25 25 25 25 25 32 10 43 18 12 17 10 40 10 43 10 40 10 10 10 10 10 40 10 44 43 10 40 10 44 10 10 24 20 20 20 20 23 10 10 40 10 31 25 26 27 25 25 25
25 25 25 25 27 25 38 29 10 18 12 17 40 10 10 10 10 10 43 10 11 10 10 10 11 10 10 28 30 29 10 44 10 10 10 28 30 30 30 29 10 10 10 31 25 25 25 25 25 25
25 25 26 25 25 25 27 32 11 18 12 17 10 10 43 10 40 44 10 10 10 43 10 10 10 10 10 31 27 32 10 11 43 10 44 31 25 25 27 38 30 30 30 39 25 25 26 25 25 25
25 25 25 25 25 25 25 32 10 18 12 17 10 44 10 10 10 10 43 10 10 10 10 10 10 43 10 33 35 34 40 10 10 28 30 39 25 25 25 25 25 25 25 25 25 25 25 25 25 25
25 25 25 27 25 25 25 32 10 18 12 17 11 10 10 10 11 10 10 10 10 10 10 44 10 10 10 10 44 40 10 10 28 39 25 25 26 25 25 25 25 25 27 25 25 25 25 25 25 25
25 25 25 25 25 25 36 34 44 18 12 16 19 19 19 19 19 19 19 19 19 19 19 22 11 10 10 44 43 10 10 43 31 25 25 25 25 25 25 25 25 25 25 25 25 25 25 25 25 25
25 25 25 25 25 25 32 44 40 18 12 12 12 12 12 12 12 12 12 12 12 12 12 17 10 10 10 10 44 10 11 10 31 25 26 25 25 25 25 25 26 25 25 25 25 25 25 27 25 26
25 25 25 25 25 25 32 10 10 24 20 14 12 13 20 20 20 20 20 20 20 14 12 17 10 11 10 11 10 10 44 10 33 37 25 25 25 25 25 25 25 25 25 26 25 25 25 25 25 25
26 25 25 25 25 25 32 43 40 11 40 18 12 17 10 44 10 10 10 10 11 18 12 16 22 10 10 10 44 43 10 43 44 31 25 25 25 25 25 27 25 25 25 25 25 25 25 25 25 25
25 25 25 25 25 25 32 44 40 44 40 18 12 17 40 10 44 10 10 44 10 18 12 12 17 44 10 10 10 10 10 10 28 39 27 36 35 37 25 25 25 25 25 25 25 25 25 25 25 25
27 25 25 25 25 25 32 40 40 40 11 18 12 17 10 10 10 11 10 10 40 24 14 12 16 19 19 19 19 22 44 10 33 35 35 34 11 33 35 35 35 35 35 37 25 25 25 25 25 25
25 25 25 25 25 25 32 44 40 40 44 18 12 17 10 10 10 10 44 10 21 19 15 12 12 12 12 12 12 17 10 10 10 43 10 10 44 10 10 10 10 10 11 31 25 25 26 25 25 25
25 25 27 26 25 25 32 10 44 40 40 24 20 23 28 30 30 30 29 44 18 12 12 12 13 20 20 14 12 17 10 40 10 10 10 10 10 10 10 10 28 30 30 39 25 25 27 25 25 25
25 25 25 25 25 25 32 11 10 10 40 40 43 28 39 25 25 25 32 10 18 12 13 20 23 44 10 18 12 16 19 22 40 10 10 43 10 44 10 10 31 27 25 25 25 25 25 25 25 27
25 25 25 25 25 25 32 10 44 10 10 28 30 39 25 36 35 35 34 10 18 12 17 10 10 10 10 18 12 12 12 17 11 10 10 40 10 10 10 10 31 25 25 25 25 25 25 26 25 25
25 25 25 25 25 25 32 10 10 28 30 39 25 25 36 34 10 10 10 10 18 12 17 10 44 10 10 24 20 14 12 16 19 19 22 10 10 10 10 40 31 27 25 25 25 25 25 25 25 25
27 25 25 25 25 25 32 10 28 39 25 25 36 35 34 40 10 10 44 10 18 12 17 10 43 40 10 44 10 18 12 12 12 12 16 19 22 11 10 43 31 25 25 25 25 26 25 25 25 25
25 26 25 25 25 25 38 30 39 25 36 35 34 10 10 10 10 43 10 10 18 12 17 10 10 10 10 10 10 24 20 20 14 12 12 12 17 10 10 10 31 25 25 25 25 25 25 25 25 25
25 25 25 25 25 25 25 25 25 25 32 10 10 21 19 19 19 19 19 19 15 12 17 40 10 10 10 10 10 10 40 10 24 20 14 12 16 19 19 22 33 35 35 37 25 25 25 25 25 25
25 25 27 25 25 25 36 35 35 35 34 43 40 18 12 12 12 12 12 12 12 12 17 10 10 10 10 10 10 43 10 44 10 10 18 12 12 12 12 17 11 10 44 31 25 25 25 25 25 25
25 25 25 25 25 25 32 10 40 11 21 19 19 15 12 13 20 20 20 20 20 20 23 10 10 43 10 10 10 10 10 10 43 40 24 20 20 20 20 23 10 10 10 31 25 25 27 25 25 25
25 25 25 25 25 25 32 10 10 21 15 12 12 12 12 17 10 10 10 10 10 10 44 43 10 10 10 10 40 10 28 30 30 30 30 30 30 29 40 10 10 10 10 31 25 25 26 25 25 25
25 25 25 26 25 25 32 44 10 18 12 12 13 20 20 23 10 10 43 44 10 10 10 10 40 10 10 11 10 10 31 26 25 25 25 26 25 32 10 11 10 10 43 31 25 25 25 25 25 25
25 25 25 25 25 25 32 10 10 24 20 20 23 40 10 10 10 44 11 10 10 40 10 44 10 44 10 43 10 10 31 25 25 25 25 25 25 32 10 10 10 43 11 31 25 25 25 25 27 25
27 25 25 25 25 25 32 10 10 10 10 10 10 10 43 10 10 10 10 10 10 10 10 10 10 10 10 10 10 43 31 25 25 25 26 25 26 32 10 10 10 10 10 31 25 25 25 25 25 25
25 26 25 25 25 25 32 40 44 10 10 43 10 10 44 10 10 10 10 40 10 10 28 30 30 30 30 30 30 30 39 25 25 26 25 25 25 32 44 11 10 11 28 39 25 25 25 25 25 26
25 25 25 25 25 25 38 30 30 30 30 30 30 30 30 30 30 30 30 30 30 30 39 25 25 25 25 25 25 25 25 25 25 25 25 25 25 38 30 30 30 30 39 26 25 25 25 25 25 25
25 25 27 25 25 25 25 25 25 25 25 25 25 25 25 25 25 25 25 25 25 25 25 25 25 25 25 25 25 25 25 25 25 25 25 25 25 25 25 25 25 25 25 25 25 25 26 25 25 27
25 25 25 25 25 25 25 27 25 25 25 26 25 25 27 25 25 25 25 25 25 25 25 25 25 25 25 25 26 25 25 25 25 25 25 25 25 25 25 27 26 25 25 25 25 25 25 25 25 25
27 25 25 25 25 25 25 25 25 25 25 25 25 25 25 25 25 25 25 27 25 25 25 25 27 25 25 25 25 25 27 25 25 25 25 25 25 25 25 25 25 25 25 25 25 25 26 25 25 25
25 25 25 25 25 25 25 25 25 27 25 25 25 25 25 25 25 26 25 25 25 25 25 25 25 25 25 25 25 25 25 25 26 25 25 25 25 25 25 25 25 25 25 25 25 25 27 25 25 25
25 26 25 27 25 25 25 25 25 25 25 25 27 25 25 25 25 25 25 25 25 25 27 25 25 25 25 25 25 25 25 25 25 25 25 27 25 25 25 25 26 25 25 25 25 25 25 25 26 25
27 25 25 25 25 25 25 25 25 25 25 25 25 25 25 25 25 25 25 25 25 25 25 25 25 25 25 25 25 25 25 25 25 25 25 25 25 25 25 25 25 25 25 25 27 25 25 25 25 25